0000000000000000000000000000000000000000000000000000000000000000000000000000000000000
0000000000000000000000000000000000000000000000000000000000000000000000000000000000000
00000000000000000000000g0000000000000000000000000000000000000000000000000000000000000
0000000000000000000000000000000000000000000000000000000000000000000000000000000000000
0000000000000000000000000000000000000000000000000000000000000000000000000000000000000
0000000000000000000000000000000000000000000000000000000000000000000000000000000000000
0000000000000000000000000000000000000000000000000000000000000000000000000000000000000
0                        gg              h                                    d000000
0                                                                   p       000000000
0         m                           p                      b                 000000
0       0000000                                           000000               000000
0                 p                                                            000000
0                                                                       p      000000
0                      p                                                       000000
0                                                                p             000000
0                               b        b                                     000000
0                        0  m                 m    0                      0  e 000000
0                       0000000000000000000000000000000                  000000     0
0            h                                      h                          000000
0                                     f                                        000000
0          m        p                                           f  m           000000
0                 m                                        00000000000         000000
0           00000000000                                                        000000
0     p                    m            p                                      000000
0      s                            l                                 m        000000
0                                                                              000000
0       l                                     p                                000000
0                                                                              000000
0m           fff           m      ff                  mmm            ffffffffff000000
0000000000000000000000000000000000000000000000000000000000000000000000000000000000000
0000000000000000000000000000000000000000000000000000000000000000000000000000000000000
0000000000000000000000000000000000000000000000000000000000000000000000000000000000000
0000000000000000000000000000000000000000000000000000000000000000000000000000000000000
0000000000000000000000000000000000000000000000000000000000000000000000000000000000000