00000000000000000000000000000000000000000000000000000000000000000000000000000000
00000000000000000000000000000000000000000000000000000000000000000000000000000000
00000000000000000000000g00000000000000000000000000000000000000000000000000000000
00000000000000000000000000000000000000000000000000000000000000000000000000000000
00000000000000000000000000000000000000000000000000000000000000000000000000000000
00000000000000000000000000000000000000000000000000000000000000000000000000000000
00000000000000000000000000000000000000000000000000000000000000000000000000000000
0000000000000000000000000000000000000000000000000000000000000000000000     h0000
000000000000000000000000000000000000000000000000000000000000000000     000000000
000000000000000000000000000000000000000000000000000000000000000000  000000000000
00000000000000000000000000000000000000000000000000000000000         000000000000
000000000000000000000000000000000000000000000000000000000   0 b  000000000000000
00000000000000000000000000000000000000000000000000000      000000000000000000000
0000000000000000000000000000000000000000000           00000000000000000000000000
0000000000000000000000000000000000000000         0000000000000000000000000000000
0                               b                                        b     0
0                       0000000000000000000000                                 0
0            h                                      h                          0
0                                     f                                        0
0          m        p                                                          0
0                                                          00000000000         0
0g          00000000000                  l                                     0
0  p                       m            p                                      0
0              m             e f                                               0
0  s  m  0              0000000000000000                    m                  0
0   m    0                             0                             m         0
0     b m0   ffff 0    e   0          h0     fffffffffffffffzffffffffffff     d0
00000000000000000000000000000000000000000000000000000000000000000000000000000000
00000000000000000000000000000000000000000000000000000000000000000000000000000000
00000000000000000000000000000000000000000000000000000000000000000000000000000000